Stage 1
#####
#OoP#
#####
=====
Stage 2
  #######  
###  O  ###
#    o    #
# Oo P oO #
###  o  ###
 #   O  #  
 ########  
=====
Stage 3
######  
#    ###
#   OO #
# oooP #
#  # O #
########
=====
Stage 4
###### 
#P0  ##
# o#  #
# o O #
#O   ##
###### 
=====
Stage 5
 ###### 
##    ##
# OO   #
# # ooo#
#   #PO#
########
